111111111111111111111111
1P0000000000001C00000001
10010001000000111110E001
1110011100E00C0C00000001
1C000100C000000000000001
111111111111111111111111
