111111111111
1P0000000001
1000011000011
1C000110C0E1
111111111111
