11111111111111111111111111111111111111114
1P000000000111111111111111111111111111114
10000110000111111111111111111111111111114
1C000110C0E111111111111111111111111111114
11111111111111111111111111111111111111114
