111111111111
1P0000000001
100001100001
1C000110C0E1
111111111111
